106 106 106 106 106 106 106 106 106 006 007 006 007 006 007 014 015 106 006 007 106 106 099 099 099 106 106 106 006 007 106 106 106 106 106 106 106 106 106 106 106 106 106 106 106 106 106 106 106 106
106 106 106 106 106 106 106 006 007 014 015 014 015 014 015 022 023 106 014 015 106 106 099 099 099 106 006 007 014 015 106 106 106 106 106 106 106 106 106 106 106 106 106 106 106 106 006 007 106 106
106 106 106 006 007 006 007 014 015 022 023 022 023 022 023 106 006 007 022 023 006 007 099 099 099 106 014 015 022 023 106 006 007 006 007 106 106 006 007 106 106 106 106 106 006 007 014 015 106 106
106 106 106 014 015 014 015 022 023 106 006 007 006 007 006 007 014 015 006 007 014 015 099 099 099 106 022 023 106 006 007 014 015 014 015 006 007 014 015 106 106 006 007 106 014 015 022 023 106 106
106 106 106 022 023 022 023 106 106 106 014 015 014 015 014 015 022 023 014 015 022 023 099 099 099 006 007 006 007 014 015 022 023 022 023 014 015 022 023 006 007 014 015 106 022 023 006 007 106 106
106 106 006 007 006 007 006 007 006 007 022 023 022 023 022 023 043 043 022 023 006 007 099 099 099 014 015 014 015 022 023 043 043 043 043 022 023 043 043 014 015 022 023 106 006 007 014 015 106 106
106 106 014 015 014 015 014 015 014 015 043 043 043 043 043 106 043 043 043 043 014 015 099 099 099 022 023 022 023 043 043 043 043 043 043 043 043 043 043 022 023 106 006 007 014 015 022 023 106 106
106 106 022 023 022 023 022 023 022 023 043 043 043 043 043 043 043 043 043 043 022 023 099 099 099 106 043 043 043 043 043 043 043 043 043 043 043 043 043 043 006 007 014 015 022 023 006 007 106 106
106 106 106 006 007 006 007 006 007 006 007 043 043 043 043 043 043 043 043 043 043 106 099 099 099 106 043 043 043 043 043 043 043 043 106 043 043 043 043 043 014 015 022 023 006 007 014 015 106 106
106 106 106 014 015 014 015 014 015 014 015 043 106 043 043 043 106 043 043 043 043 056 056 056 056 056 043 043 043 043 043 043 043 043 043 106 043 043 043 043 022 023 006 007 014 015 022 023 106 106
106 106 106 022 023 022 023 022 023 022 023 043 043 043 043 043 043 043 043 043 043 056 056 056 056 056 043 043 043 043 106 043 043 043 043 043 043 043 043 043 043 106 014 015 022 023 006 007 106 106
106 106 106 006 007 106 006 007 006 007 043 043 043 043 043 043 043 043 043 043 043 106 099 099 099 006 007 043 043 106 043 043 043 043 043 043 043 043 043 043 006 007 022 023 106 106 014 015 106 106
106 106 106 014 015 106 014 015 014 015 043 043 043 043 043 043 043 043 043 006 007 106 099 099 099 014 015 043 043 043 043 043 043 043 106 106 043 043 043 043 014 015 106 010 011 106 022 023 106 106
106 106 106 022 023 106 022 023 022 023 043 106 043 043 043 043 043 043 043 014 015 106 099 099 099 022 023 043 043 043 043 043 043 043 043 106 043 043 043 043 022 023 106 018 019 106 006 007 106 106
106 106 106 106 106 006 007 006 007 006 007 043 043 043 043 043 043 043 043 022 023 106 099 099 099 106 006 007 043 043 043 043 043 043 043 043 043 043 043 043 043 043 043 043 043 106 014 015 106 106
106 106 006 007 106 014 015 014 015 014 015 043 043 043 043 043 106 043 043 043 006 007 099 099 099 106 014 015 043 043 043 043 043 043 043 043 043 043 043 043 043 043 043 043 043 106 022 023 106 106
106 106 014 015 106 022 023 022 023 022 023 043 043 043 043 043 043 043 043 043 014 015 099 099 099 106 022 023 043 043 043 106 043 043 043 043 043 043 043 006 007 106 106 106 006 007 006 007 106 106
106 106 022 023 106 106 006 007 006 007 043 106 043 043 043 043 043 043 043 043 022 023 099 099 099 006 007 043 043 043 043 043 043 043 043 043 043 043 043 014 015 106 106 106 014 015 014 015 106 099
106 106 106 106 106 106 014 015 014 015 043 043 043 043 043 043 043 043 043 106 106 106 099 099 099 014 015 043 043 043 043 043 043 043 043 043 043 043 043 022 023 106 006 007 022 023 022 023 099 099
106 106 106 106 006 007 022 023 022 023 043 043 043 043 043 043 043 043 043 106 106 106 099 099 099 022 023 043 043 043 043 043 043 043 006 007 043 043 043 043 006 007 014 015 106 106 106 099 099 099
106 106 106 106 014 015 106 006 007 106 043 043 043 043 043 006 007 043 043 006 007 106 099 099 099 106 043 006 007 043 043 043 006 007 014 015 006 007 006 007 014 015 022 023 106 106 099 099 099 099
106 106 006 007 022 023 106 014 015 106 043 043 106 043 043 014 015 006 007 014 015 106 099 099 099 099 106 014 015 043 006 007 014 015 022 023 014 015 014 015 022 023 106 106 106 099 099 099 099 099
106 106 014 015 106 006 007 022 023 106 056 056 106 106 106 022 023 014 015 022 023 106 099 099 099 099 099 022 023 106 014 015 022 023 106 043 022 023 022 023 106 106 106 106 106 099 099 099 099 106
106 106 022 023 106 014 015 106 106 099 056 056 099 099 099 099 099 022 023 106 106 099 099 099 099 099 099 099 099 099 022 023 099 099 099 099 099 099 099 099 099 099 099 099 099 099 099 099 106 106
106 106 099 099 106 022 023 099 099 099 056 056 099 099 099 099 099 099 099 099 099 099 099 099 099 099 099 099 099 099 099 099 099 099 099 099 099 099 099 099 099 099 099 099 099 099 099 099 106 106
099 099 099 099 099 099 099 099 099 099 056 056 099 099 099 099 099 099 099 099 099 099 099 099 099 099 099 099 099 099 099 099 099 099 099 099 099 099 099 099 099 099 099 099 099 099 099 106 106 106
099 099 099 099 099 099 099 099 099 106 056 056 099 106 006 007 099 099 099 099 099 099 099 099 006 007 099 099 006 007 099 099 006 007 099 043 006 007 043 043 043 099 099 099 099 106 106 106 106 106
099 099 006 007 099 099 099 106 106 106 056 056 106 106 014 015 099 099 099 106 006 007 099 099 014 015 006 007 014 015 006 007 014 015 006 007 014 015 043 043 043 043 006 007 106 106 106 106 106 106
106 106 014 015 006 007 006 007 106 106 056 056 106 106 022 023 043 106 106 106 014 015 099 099 022 023 014 015 022 023 014 015 022 023 014 015 022 023 006 007 043 043 014 015 106 106 106 106 106 106
106 106 022 023 014 015 014 015 006 007 043 043 043 043 043 043 043 043 043 043 022 023 099 099 099 106 022 023 043 043 022 023 043 043 022 023 043 043 014 015 006 007 022 023 106 106 106 106 106 106
106 106 006 007 022 023 022 023 014 015 043 043 043 043 043 043 043 043 043 006 007 043 099 099 099 006 007 043 043 043 043 043 043 043 043 043 043 043 022 023 014 015 106 006 007 106 106 106 106 106
106 106 014 015 106 106 106 106 022 023 043 043 043 043 043 043 043 043 043 014 015 043 099 099 099 014 015 043 043 043 043 043 043 043 043 043 043 043 043 043 022 023 106 014 015 006 007 106 106 106
106 106 022 023 006 007 106 006 007 006 007 043 043 043 043 043 043 043 043 022 023 043 099 099 099 022 023 043 043 106 106 043 043 106 043 043 043 043 043 043 043 006 007 022 023 014 015 106 106 106
106 106 006 007 014 015 106 014 015 014 015 043 043 043 043 043 043 043 043 043 006 007 099 099 099 106 006 007 043 043 043 043 043 106 106 043 043 043 043 043 043 014 015 006 007 022 023 106 106 106
106 106 014 015 022 023 106 022 023 022 023 043 043 106 043 043 043 043 043 043 014 015 099 099 099 106 014 015 043 043 043 043 043 043 106 043 043 043 043 043 043 022 023 014 015 006 007 106 106 106
106 106 022 023 006 007 106 106 006 007 043 043 043 106 106 043 043 043 043 043 022 023 099 099 099 106 022 023 043 043 043 043 043 043 043 043 043 043 043 043 043 043 043 022 023 014 015 106 106 106
106 106 106 106 014 015 006 007 014 015 043 043 043 106 043 043 043 043 043 043 043 006 007 099 099 099 043 006 007 043 043 106 043 043 043 043 043 043 043 043 043 043 043 006 007 022 023 106 106 106
106 106 106 106 022 023 014 015 022 023 043 043 043 043 043 043 043 043 043 043 043 014 015 099 099 099 043 014 015 043 043 043 043 043 043 043 043 043 106 043 043 043 043 014 015 006 007 106 106 106
106 106 106 106 006 007 022 023 106 006 007 043 043 043 043 043 043 043 043 043 043 022 023 106 099 099 099 022 023 043 043 043 043 043 043 043 043 006 007 106 043 043 106 022 023 014 015 106 106 106
106 106 106 106 014 015 106 006 007 014 015 043 043 043 043 106 043 043 043 043 043 043 106 106 099 099 099 106 106 043 043 043 043 043 043 106 106 014 015 106 010 011 106 006 007 022 023 106 106 106
106 106 106 106 022 023 106 014 015 022 023 043 043 043 043 043 043 043 043 043 043 043 056 056 056 056 056 056 056 043 043 043 043 043 043 043 106 022 023 106 018 019 106 014 015 006 007 106 106 106
106 106 106 106 106 006 007 022 023 043 006 007 043 043 043 043 043 043 043 043 043 043 056 056 056 056 056 056 056 043 043 043 043 043 043 043 043 043 043 106 106 106 106 022 023 014 015 106 106 106
106 106 106 106 106 014 015 106 006 007 014 015 006 007 043 043 043 043 043 043 043 106 006 007 099 099 099 106 106 007 043 043 043 043 043 043 043 043 106 106 006 007 006 007 106 022 023 106 106 106
106 106 106 106 106 022 023 106 014 015 022 023 014 015 043 043 006 007 043 043 006 007 014 015 099 099 099 106 014 015 043 043 006 007 006 007 043 043 006 007 014 015 014 015 006 007 106 106 106 106
106 106 106 106 106 106 106 106 022 023 043 043 022 023 006 007 014 015 006 007 014 015 022 023 099 099 099 106 022 023 006 007 014 015 014 015 006 007 014 015 022 023 022 023 014 015 106 106 106 106
106 106 106 106 106 106 106 006 007 006 007 043 043 043 014 015 022 023 014 015 022 023 106 099 099 099 106 006 007 106 014 015 022 023 022 023 014 015 022 023 006 007 106 106 022 023 106 106 106 106
106 106 106 106 106 106 106 014 015 014 015 106 106 106 022 023 106 106 022 023 106 106 106 099 099 099 106 014 015 106 022 023 106 106 006 007 022 023 106 106 014 015 106 106 106 106 106 106 106 106
106 106 106 106 106 106 106 022 023 022 023 106 106 106 106 106 106 106 106 106 106 106 099 099 099 106 106 022 023 006 007 106 006 007 014 015 106 106 106 106 022 023 106 106 106 106 106 106 106 106
106 106 106 106 106 106 106 106 106 106 106 106 106 106 106 106 106 106 106 106 106 106 099 099 099 106 106 106 106 014 015 106 014 015 022 023 106 106 106 106 106 106 106 106 106 106 106 106 106 106
106 106 106 106 106 106 106 106 106 106 106 106 106 106 106 106 106 106 106 106 106 099 099 099 106 106 106 106 106 022 023 106 022 023 106 106 106 106 106 106 106 106 106 106 106 106 106 106 106 106