099 099 099 099 099 099 099 099 099 099 099 099 099 099 099 099 099 099 099 099 099 099 099 099 099 099 099 099 099 099 099 099 099 099 099 099 099 099 099 099 099 099 099 099 099 099 099 099 099 099
099 099 099 099 099 099 099 099 099 099 099 099 099 099 099 099 099 099 099 099 099 099 099 099 099 099 099 099 099 099 099 099 099 099 099 099 099 099 099 099 099 099 099 099 099 099 099 099 099 099
099 099 099 099 099 099 099 099 099 099 099 099 099 099 099 099 099 099 099 099 099 099 099 099 099 099 099 099 099 099 099 099 099 099 099 099 099 099 099 099 099 099 099 099 099 099 099 099 099 099
099 099 099 099 099 099 099 099 099 099 099 099 099 099 099 099 099 099 099 099 099 099 099 099 099 099 099 099 099 099 099 099 099 099 099 099 099 099 099 099 099 099 099 099 099 099 099 099 099 099
099 099 099 099 099 099 099 099 099 099 099 099 099 099 099 099 099 099 099 099 099 099 099 099 099 099 099 099 099 099 099 098 098 098 099 099 099 098 098 098 099 099 099 099 099 099 099 099 099 099
099 099 099 099 099 099 099 099 099 099 099 099 099 099 099 099 099 098 098 099 099 099 099 099 099 099 099 099 099 098 098 098 098 098 098 098 098 098 098 098 098 099 099 099 099 099 099 099 099 099
099 099 099 099 099 099 099 099 099 099 099 098 098 098 098 099 098 100 100 098 099 099 099 099 099 099 099 099 098 098 100 100 100 100 100 100 100 100 100 100 098 098 099 099 099 099 099 099 099 099
099 099 099 099 099 099 099 099 099 099 098 100 100 100 098 098 098 100 100 100 098 099 099 099 099 099 098 098 098 098 100 100 100 100 100 100 100 100 100 100 098 099 099 099 099 099 099 099 099 099
099 099 099 099 099 099 099 099 099 098 100 100 100 100 100 100 100 100 100 100 098 099 099 099 099 099 098 100 100 100 100 100 100 100 100 100 100 100 100 100 098 098 099 099 099 099 099 099 099 099
099 099 099 099 099 099 099 099 099 098 100 100 100 100 100 100 100 100 100 100 000 000 000 000 000 000 000 100 100 100 100 100 100 100 100 098 100 100 100 100 100 098 099 099 099 099 099 099 099 099
099 099 099 099 099 099 099 099 098 098 100 100 100 100 100 100 100 100 100 100 000 000 000 000 000 000 000 100 100 100 100 100 100 100 098 098 098 100 100 100 100 099 099 099 099 099 099 099 099 099
099 099 099 099 099 099 099 099 098 100 098 100 100 100 100 100 100 100 100 100 098 099 099 099 099 099 098 098 100 100 100 100 100 100 100 098 098 100 100 100 098 099 099 099 099 099 099 099 099 099
099 099 099 099 099 099 099 099 099 100 098 100 100 100 100 100 100 100 100 100 098 099 099 099 099 099 098 098 100 100 100 100 100 100 100 100 100 100 100 100 098 099 099 099 099 099 099 099 099 099
099 099 099 099 099 099 099 099 099 100 098 098 100 100 100 100 100 100 100 100 098 099 099 099 099 099 098 100 100 100 100 100 100 098 100 100 100 100 100 100 098 099 099 099 099 099 099 099 099 099
099 099 099 099 099 099 099 099 099 099 098 098 100 100 100 100 100 100 100 100 100 098 099 099 099 098 098 100 098 098 098 098 098 100 100 100 100 100 100 098 098 099 099 099 099 099 099 099 099 099
099 099 099 099 099 099 099 099 099 099 098 098 100 098 098 100 100 100 100 100 100 098 099 099 099 098 098 098 098 100 100 098 098 100 100 100 100 100 098 098 098 098 099 099 099 099 099 099 099 099
099 099 099 099 099 099 099 099 099 099 098 100 100 100 098 098 098 100 100 100 100 100 098 099 099 098 098 100 098 100 100 100 098 100 100 100 100 100 098 098 098 098 098 099 099 099 099 099 099 099
099 099 099 099 099 099 099 099 099 100 098 100 100 100 098 100 100 100 100 100 100 100 098 099 099 098 098 100 098 100 100 100 100 100 100 100 100 100 098 100 098 100 098 099 099 099 099 099 099 099
099 099 099 099 099 099 099 099 098 098 098 100 100 100 098 100 100 100 100 100 100 098 099 099 099 098 098 100 100 100 100 100 100 100 100 100 100 100 100 100 100 098 098 099 099 099 099 099 099 099
099 099 099 099 099 099 099 099 098 098 098 100 100 100 100 100 100 100 100 100 100 098 099 099 099 099 098 100 100 100 100 100 100 100 100 100 100 100 100 100 100 098 099 099 099 099 099 099 099 099
099 099 099 099 099 099 099 099 098 098 098 100 100 100 100 100 100 100 100 100 098 099 099 099 099 099 098 098 100 100 100 100 100 100 100 100 100 100 100 100 098 098 099 099 099 099 099 099 099 099
099 099 099 099 099 099 099 099 099 098 100 100 100 100 100 100 100 100 100 098 099 099 099 099 099 099 099 098 098 098 000 000 098 098 098 098 100 100 100 098 098 098 099 099 099 099 099 099 099 099
099 099 099 099 099 099 099 099 099 099 099 098 100 100 100 100 098 099 099 099 099 099 099 099 099 099 099 099 099 099 000 000 099 099 099 099 098 098 098 099 099 099 099 099 099 099 099 099 099 099
099 099 099 099 099 099 099 099 099 099 099 099 098 098 098 098 099 099 099 099 099 099 099 099 099 099 099 099 099 099 000 000 099 099 099 099 099 099 099 099 099 099 099 099 099 099 099 099 099 099
099 099 099 099 099 099 099 099 099 099 099 099 099 099 099 099 099 099 099 099 099 099 099 099 099 099 099 099 099 099 000 000 099 099 099 099 099 099 099 099 099 099 099 099 099 099 099 099 099 099
099 099 099 099 099 099 099 099 099 099 099 099 099 099 099 099 099 099 099 099 099 099 099 099 099 099 099 099 099 099 000 000 099 099 099 099 098 098 098 098 099 099 099 099 099 099 099 099 099 099
099 099 099 099 099 099 099 099 099 099 099 099 099 098 098 099 099 099 099 099 099 099 099 099 099 099 099 099 099 099 000 000 099 099 099 098 098 098 098 098 098 099 099 099 099 099 099 099 099 099
099 099 099 099 099 099 099 099 099 099 099 098 098 098 098 098 098 098 098 098 099 099 099 099 099 099 099 099 099 099 000 000 099 099 099 098 100 100 100 100 098 098 099 099 099 099 099 099 099 099
099 099 099 099 099 099 099 099 099 098 098 098 098 030 031 098 098 099 099 098 099 099 099 099 099 099 099 098 098 098 000 000 098 098 098 098 100 100 100 100 100 098 099 099 099 099 099 099 099 099
099 099 099 099 099 099 099 099 099 098 098 098 098 038 039 098 098 098 098 098 098 099 099 099 099 099 098 098 100 100 100 100 100 100 100 100 100 100 100 100 100 098 098 099 099 099 099 099 099 099
099 099 099 099 099 099 099 099 099 098 099 099 098 100 100 098 099 099 099 098 099 098 099 099 099 098 098 100 100 100 100 100 100 100 100 100 100 100 100 100 100 098 098 099 099 099 099 099 099 099
099 099 099 099 099 099 099 099 099 098 099 098 098 100 100 098 098 098 100 100 100 098 098 099 099 098 098 100 100 100 100 100 100 100 100 100 100 098 098 100 100 098 099 099 099 099 099 099 099 099
099 099 099 099 099 099 099 099 099 098 100 100 100 100 100 100 098 100 100 100 100 098 098 099 099 098 098 100 100 100 100 100 100 100 100 100 098 098 098 100 100 098 098 099 099 099 099 099 099 099
099 099 099 099 099 099 099 099 098 098 100 100 100 100 100 100 098 100 100 100 100 098 098 099 099 099 098 100 100 100 098 098 100 100 100 100 100 098 098 100 100 098 098 098 099 099 099 099 099 099
099 099 099 099 099 099 099 098 098 098 100 100 100 100 100 100 098 100 100 100 100 098 098 099 099 099 098 100 100 100 098 098 098 100 100 100 100 100 100 100 098 098 098 098 099 099 099 099 099 099
099 099 099 099 099 099 099 098 098 098 100 100 100 100 100 100 098 100 100 100 100 098 098 099 099 099 099 098 098 098 100 100 098 100 100 100 100 100 100 100 098 098 098 099 099 099 099 099 099 099
099 099 099 099 099 099 099 099 098 098 100 100 098 098 098 098 098 100 100 100 100 098 099 099 099 099 099 099 098 098 100 100 098 100 100 100 100 100 100 098 098 098 098 099 099 099 099 099 099 099
099 099 099 099 099 099 099 098 098 098 100 100 098 100 100 100 100 100 100 100 100 098 099 099 099 099 099 099 099 098 100 100 100 100 100 100 100 098 098 098 100 098 098 099 099 099 099 099 099 099
099 099 099 099 099 099 099 099 098 098 100 100 100 100 100 100 100 100 100 100 100 000 000 000 000 000 000 000 000 000 100 100 100 100 100 100 100 098 098 100 100 098 098 099 099 099 099 099 099 099
099 099 099 099 099 099 099 099 099 098 100 100 100 100 100 100 100 100 100 100 100 000 000 000 000 000 000 000 000 000 100 100 100 100 100 100 100 100 100 100 100 098 099 099 099 099 099 099 099 099
099 099 099 099 099 099 099 099 099 098 100 100 100 100 098 100 100 100 100 100 100 098 099 099 099 099 099 099 098 098 100 100 100 100 100 100 100 100 100 100 098 098 099 099 099 099 099 099 099 099
099 099 099 099 099 099 099 099 098 098 100 100 100 100 100 100 100 100 100 100 100 098 099 099 099 099 099 099 098 098 100 100 100 100 098 098 100 100 100 100 098 099 099 099 099 099 099 099 099 099
099 099 099 099 099 099 099 099 098 098 098 100 100 100 100 100 100 100 100 100 100 098 099 099 099 099 099 099 099 098 098 098 098 098 098 098 100 100 098 098 098 099 099 099 099 099 099 099 099 099
099 099 099 099 099 099 099 099 099 098 098 098 098 098 098 098 098 098 098 098 098 099 099 099 099 099 099 099 099 099 098 098 098 099 099 098 098 098 098 099 099 099 099 099 099 099 099 099 099 099
099 099 099 099 099 099 099 099 099 099 099 099 098 099 099 099 099 099 099 099 099 099 099 099 099 099 099 099 099 099 099 099 099 099 099 099 099 099 099 099 099 099 099 099 099 099 099 099 099 099
099 099 099 099 099 099 099 099 099 099 099 099 099 099 099 099 099 099 099 099 099 099 099 099 099 099 099 099 099 099 099 099 099 099 099 099 099 099 099 099 099 099 099 099 099 099 099 099 099 099
099 099 099 099 099 099 099 099 099 099 099 099 099 099 099 099 099 099 099 099 099 099 099 099 099 099 099 099 099 099 099 099 099 099 099 099 099 099 099 099 099 099 099 099 099 099 099 099 099 099
099 099 099 099 099 099 099 099 099 099 099 099 099 099 099 099 099 099 099 099 099 099 099 099 099 099 099 099 099 099 099 099 099 099 099 099 099 099 099 099 099 099 099 099 099 099 099 099 099 099
099 099 099 099 099 099 099 099 099 099 099 099 099 099 099 099 099 099 099 099 099 099 099 099 099 099 099 099 099 099 099 099 099 099 099 099 099 099 099 099 099 099 099 099 099 099 099 099 099 099
099 099 099 099 099 099 099 099 099 099 099 099 099 099 099 099 099 099 099 099 099 099 099 099 099 099 099 099 099 099 099 099 099 099 099 099 099 099 099 099 099 099 099 099 099 099 099 099 099 099