114 114 114 114 114 114 114 114 114 114 114 114 114 114 114 114 114 114 114 114 114 114 114 114 114 114 114 114 114 114 114 114 114 114 114 114 114 114 114 114 114 114 114 114 114 114 114 114 114 114
114 114 114 114 114 114 114 114 114 114 119 114 114 114 114 114 114 114 114 114 114 114 114 114 114 114 114 114 114 114 114 114 114 114 114 114 114 114 119 114 114 114 114 114 114 114 114 114 114 114
114 114 114 114 114 114 114 114 051 080 114 114 114 114 114 119 114 114 114 114 051 080 114 114 114 114 114 114 114 114 114 114 114 114 114 114 114 114 114 119 114 114 114 114 114 114 114 114 114 114
114 114 114 114 114 114 114 114 073 114 114 051 080 114 114 114 114 114 114 114 073 114 114 114 114 114 114 114 119 114 114 114 114 114 114 051 080 114 114 114 114 114 114 114 114 114 114 114 114 114
114 114 114 114 114 114 114 114 114 114 114 073 114 114 114 114 114 114 119 114 114 114 119 114 114 114 114 114 114 114 114 114 114 114 114 073 114 114 119 114 114 051 080 114 114 114 114 114 114 114
114 114 114 114 114 114 114 114 114 114 114 114 114 114 114 114 114 114 114 114 114 114 114 114 051 080 114 114 114 114 119 114 114 114 114 114 114 114 114 114 114 073 114 119 114 114 114 114 114 114
114 114 114 114 114 114 114 114 114 104 052 052 104 104 104 104 104 104 051 052 080 114 114 119 073 114 114 114 114 119 114 104 052 052 104 104 104 104 104 104 051 052 080 114 114 114 114 114 114 114
114 114 114 114 114 114 114 114 114 051 077 079 079 079 079 079 079 079 079 052 080 114 114 114 114 114 051 080 114 114 114 051 077 079 079 079 079 079 079 079 079 052 080 114 114 114 114 114 114 114
114 114 114 114 114 114 114 114 114 052 109 109 109 109 109 109 109 109 109 104 080 114 114 114 114 114 073 114 114 114 114 104 078 109 109 109 109 109 109 109 109 104 080 114 114 114 114 114 114 114
114 114 114 114 114 114 114 114 114 104 078 109 109 109 109 109 109 109 109 104 051 052 052 104 104 104 104 104 104 104 051 052 109 109 109 109 109 109 109 109 109 104 080 114 114 114 114 114 114 114
114 114 114 114 114 114 114 114 114 104 078 109 109 109 109 109 109 109 109 079 079 079 079 079 079 079 079 079 079 079 079 079 109 109 109 109 109 109 109 109 109 104 080 114 119 114 114 114 114 114
114 114 114 114 114 114 114 114 114 104 078 109 109 109 109 109 109 109 109 109 109 109 109 109 109 109 109 109 109 109 109 109 109 109 109 109 109 109 109 109 109 104 080 119 114 114 114 114 114 114
114 114 114 114 114 114 051 080 114 104 078 109 109 109 109 109 109 109 109 104 104 104 104 051 052 052 052 104 104 104 104 051 078 109 109 109 109 109 109 109 109 104 080 114 114 114 114 114 114 114
114 114 114 114 114 114 073 114 114 104 078 109 109 109 109 109 109 109 109 104 082 081 081 081 081 081 081 081 081 081 081 052 109 109 109 109 109 109 109 109 109 052 080 114 114 114 114 114 114 114
114 114 114 114 114 114 114 114 114 104 078 109 109 109 109 109 109 109 109 104 072 073 073 073 073 073 073 073 073 073 073 052 109 109 109 109 109 109 109 109 109 052 080 114 114 114 114 114 114 114
114 114 114 114 114 114 114 114 119 104 078 109 109 109 109 109 109 109 109 104 080 114 114 114 119 114 114 114 114 114 114 104 078 109 109 109 109 109 109 109 109 052 080 114 114 114 114 114 114 114
114 114 114 114 114 114 114 114 114 104 104 104 104 078 109 109 051 104 104 104 080 114 051 080 114 114 114 114 114 114 119 104 104 104 051 078 109 109 104 104 104 051 080 114 114 114 114 114 114 114
114 114 114 114 114 114 114 114 114 082 081 081 084 076 085 085 084 082 081 081 080 114 073 114 114 114 114 114 051 080 114 082 081 081 084 076 085 085 084 082 081 081 080 114 114 114 114 114 114 114
114 114 114 114 114 114 114 114 114 073 073 073 084 076 085 085 084 072 073 073 114 114 114 114 114 114 114 114 073 114 114 073 073 073 084 076 085 085 084 072 073 073 114 114 114 114 114 114 114 114
114 114 114 114 114 114 114 114 114 114 114 114 084 076 085 085 084 080 119 052 104 104 052 052 104 104 051 052 052 104 104 051 080 114 084 076 085 085 084 080 114 114 114 051 080 114 114 114 114 114
114 114 114 114 114 114 114 114 114 114 051 080 051 078 109 109 104 080 119 052 079 079 109 109 079 079 109 109 109 079 079 052 080 114 051 078 109 109 104 080 114 114 114 073 114 114 114 114 114 114
114 114 114 114 114 114 114 114 114 114 073 114 052 078 109 109 052 080 114 051 078 109 109 109 109 109 109 109 109 109 109 104 080 114 052 109 109 109 104 080 114 114 114 114 114 114 114 114 114 114
114 114 114 114 114 114 114 114 114 114 119 114 052 078 109 109 052 080 114 051 078 109 109 109 109 109 109 109 109 109 109 104 080 114 052 109 109 109 104 080 114 114 114 114 119 114 114 114 114 114
114 114 114 114 114 114 119 114 114 119 114 119 104 078 109 109 052 080 114 104 078 109 109 109 109 109 109 109 109 109 109 104 080 119 052 109 109 109 104 080 114 114 114 114 114 114 114 114 114 114
114 114 114 114 114 114 114 114 114 114 114 114 104 078 109 109 104 080 114 104 078 109 109 109 109 109 109 109 109 109 109 104 080 114 052 109 109 109 104 080 114 114 114 114 114 114 114 114 114 114
114 114 114 114 114 114 114 114 114 114 114 114 104 078 109 109 104 080 114 104 078 109 109 109 109 109 109 109 109 109 109 104 080 114 104 078 109 109 104 080 114 114 114 114 119 114 114 114 114 114
114 114 114 114 114 114 114 114 114 114 051 080 104 078 109 109 104 080 114 104 078 109 109 109 109 109 109 109 109 109 109 104 080 114 104 078 109 109 104 080 114 114 114 119 114 114 114 114 114 114
114 114 114 114 114 114 114 119 114 114 073 114 104 078 109 109 104 080 114 104 078 109 109 109 109 109 109 109 109 109 109 104 080 114 104 078 109 109 051 080 114 114 114 114 114 114 114 114 114 114
114 114 114 114 114 114 114 114 114 114 114 114 104 078 109 109 104 080 114 104 078 109 109 109 109 109 109 109 109 109 109 104 080 114 104 078 109 109 052 080 114 114 114 114 114 114 114 114 114 114
114 114 114 114 114 114 114 114 114 114 114 114 052 078 109 109 104 080 114 104 078 109 109 109 109 109 109 109 109 109 109 104 080 114 104 078 109 109 052 080 114 051 080 114 114 114 114 114 114 114
114 114 114 114 114 114 114 114 114 051 080 114 052 078 109 109 104 080 114 104 078 109 109 109 109 109 109 109 109 109 109 051 080 114 051 078 109 109 104 080 114 073 114 114 114 114 114 114 114 114
114 114 114 114 114 114 114 114 114 073 114 114 084 076 085 085 084 080 114 104 104 051 051 052 109 109 109 104 104 104 051 052 080 114 084 076 085 085 084 080 114 114 114 114 114 114 114 114 114 114
114 114 114 114 114 114 114 119 114 114 114 114 084 076 085 085 084 080 114 082 081 081 081 084 076 085 085 052 082 081 081 081 080 114 084 076 085 085 084 080 114 114 114 114 114 114 114 114 114 114
114 114 114 114 114 114 114 114 114 114 114 114 084 076 085 085 084 080 114 073 073 073 073 084 076 085 085 052 072 073 073 073 119 114 084 076 085 085 084 080 114 114 114 114 051 080 114 114 114 114
114 114 114 114 114 114 114 114 114 104 104 104 051 078 109 109 104 104 051 052 080 114 119 084 076 085 085 084 080 114 114 104 104 051 104 078 109 109 051 052 052 052 080 114 073 114 114 114 114 114
114 114 114 114 114 114 114 114 114 052 079 079 079 109 109 109 079 079 079 104 080 114 114 084 076 085 085 084 080 114 114 104 077 079 079 109 109 109 079 079 079 104 080 114 114 119 114 114 114 114
114 114 114 114 114 114 114 051 080 052 109 109 109 109 109 109 109 109 109 104 104 104 051 052 078 109 109 104 104 104 104 104 078 109 109 109 109 109 109 109 109 104 080 114 114 114 114 114 114 114
114 114 114 114 114 114 114 073 114 104 078 109 109 109 109 109 109 109 109 079 079 079 079 079 109 109 109 079 079 079 079 079 109 109 109 109 109 109 109 109 109 052 080 114 114 114 114 114 114 114
114 114 114 114 114 114 114 114 114 104 078 109 109 109 109 109 109 109 109 109 109 109 109 109 109 109 109 109 109 109 109 109 109 109 109 109 109 109 109 109 109 052 080 114 114 114 114 114 114 114
114 114 114 114 114 114 114 114 119 104 078 109 109 109 109 109 109 109 109 051 052 104 104 051 078 109 109 104 051 052 104 051 078 109 109 109 109 109 109 109 109 104 080 114 114 051 080 114 114 114
114 114 114 114 114 114 051 080 114 104 078 109 109 109 109 109 109 109 109 104 082 081 081 084 076 085 085 084 082 081 081 052 078 109 109 109 109 109 109 109 109 104 080 114 114 073 114 114 114 114
114 114 114 114 114 114 073 119 114 104 078 109 109 109 109 109 109 109 109 104 072 073 073 052 076 085 085 084 072 073 073 104 078 109 109 109 109 109 109 109 109 104 080 114 114 114 119 114 114 114
114 114 114 114 114 114 114 114 114 104 078 109 109 109 109 109 109 109 109 104 080 114 119 052 076 085 085 084 080 114 114 104 078 109 109 109 109 109 109 109 109 104 080 114 114 114 114 114 114 114
114 114 114 114 114 114 114 114 114 104 078 109 109 109 109 109 109 109 109 104 080 114 114 073 073 073 073 073 114 114 114 104 078 109 109 109 109 109 109 109 109 052 080 114 114 114 114 114 114 114
114 114 114 114 114 119 114 114 114 051 052 052 052 104 104 104 104 104 104 104 080 119 114 119 061 062 063 119 114 114 119 104 052 052 104 104 104 104 104 104 051 052 080 114 114 114 114 114 114 114
114 114 114 114 114 114 114 114 114 082 081 081 081 081 081 081 081 081 081 081 080 051 080 119 069 070 071 119 114 051 080 082 081 081 081 081 081 081 081 081 081 081 080 114 051 080 114 114 114 114
114 114 114 114 114 114 114 119 114 073 073 073 073 073 073 073 073 073 073 073 114 073 114 114 119 119 119 114 114 073 114 073 073 073 073 073 073 073 073 073 073 073 114 114 073 114 114 114 114 114
114 114 114 114 114 114 114 114 119 114 114 114 114 119 114 114 114 114 114 114 114 114 080 114 114 114 114 051 080 114 114 114 114 114 114 114 119 114 114 114 114 114 114 114 114 114 114 114 114 114
114 114 114 114 114 114 114 114 114 114 051 080 114 114 114 114 114 114 114 114 114 114 051 080 114 114 114 073 114 119 114 114 051 080 114 119 114 114 114 114 051 080 114 114 114 114 114 114 114 114
114 114 114 114 114 114 114 114 114 114 073 114 114 114 114 114 114 114 114 114 114 114 073 114 114 114 114 114 114 114 114 114 073 114 114 114 114 114 114 114 073 114 114 114 114 114 114 114 114 114